12 11 10 10 10 10 10 10 11
11 11 09 09 09 09 09 09 10
10 09 09 09 08 09 09 09 10
10 09 09 09 09 09 09 09 10
10 09 08 09 09 09 08 09 10
11 10 10 11 09 09 09 09 10
12 12 12 10 08 09 09 09 10
12 12 12 10 09 09 09 11 11
12 12 12 11 10 10 10 11 12