12 12 11 10 10 10 10 11 10 10 10 10 11 12 12 
12 11 11 09 09 09 09 10 09 09 09 09 11 11 12 
11 11 11 09 09 09 09 10 09 09 09 09 11 11 11 
10 09 10 09 09 09 09 10 09 09 09 09 10 09 10 
10 09 09 09 09 08 08 10 08 08 09 09 09 09 10 
10 09 09 09 08 08 08 10 08 08 08 09 09 09 10 
10 09 09 09 08 08 09 08 09 08 08 09 09 09 10 
11 10 10 10 10 10 09 09 09 10 10 10 10 10 11 
10 09 09 09 08 08 09 09 09 08 08 09 09 09 10 
10 09 09 09 08 08 08 10 08 08 08 09 09 09 10 
10 09 09 09 09 08 08 10 08 08 09 09 09 09 10 
10 09 10 09 09 09 09 10 09 09 09 09 10 09 10 
11 11 11 09 09 09 09 10 09 09 09 09 11 11 11 
12 11 11 09 09 09 09 10 09 09 09 09 11 11 12 
12 12 11 10 10 10 10 11 10 10 10 10 11 12 12 