12 12 10 10 10 10 10 10 10 10 10 10 10 12 12 
12 10 10 09 09 09 09 10 09 09 09 09 10 10 12 
10 10 10 09 09 09 09 10 09 09 09 09 10 10 10 
10 09 10 09 09 09 09 10 09 09 09 09 10 09 10 
10 09 09 09 09 08 08 10 08 08 09 09 09 09 10 
10 09 09 09 08 08 08 10 08 08 08 09 09 09 10 
10 09 09 09 08 08 09 08 09 08 08 09 09 09 10 
10 10 10 10 10 10 09 09 09 10 10 10 10 10 10 
10 09 09 09 08 08 09 09 09 08 08 09 09 09 10 
10 09 09 09 08 08 08 10 08 08 08 09 09 09 10 
10 09 09 09 09 08 08 10 08 08 09 09 09 09 10 
10 09 10 09 09 09 09 10 09 09 09 09 10 09 10 
10 10 10 09 09 09 09 10 09 09 09 09 10 10 10 
12 10 10 09 09 09 09 10 09 09 09 09 10 10 12 
12 12 10 10 10 10 10 10 10 10 10 10 10 12 12 